0000000011000111
0110111011011111
0110111000011100
0111111111111101
1010000111111101
1011010100000000
1011000101111101
1011111101111101
1011110001110001
1000011101000111
1011011101110111
0011000001111111
1011111101110111
1000001100110000
1011011111110110
1011000000000110