0000000000000000
0000100000000010
0111111111111110
0100000000000110
0100001111000110
0100001001000110
0100001111000110
0111111111000110
0000000000000110
0000111111111110
0000100000000010
0000100000000010
0000111111100010
0000000000100010
0000000000000010
1111111111111110