0000000010000000
0111100010000010
0111111111111110
0100000000000110
0100001111000110
0100001001000110
0100001111000110
0111111111000110
0100000000000110
0100111111111110
0100100000000010
0100100000000010
0100111111100010
0111111111111111
0000000000000000
1111111111111110