0000000000000000
0111111111111100
0100000000000100
0100001111000100
0100001001000100
0100001111000100
0111111111000100
0000000000000100
0000111111111100
0000100000000000
0000100000000000
0000111111100000
0000000000100000
0111111111100000
0000000000000000
1111111111111110